COMBINED_TRACT,COMBINED_BLOCK,pop18_44,pop45_64,pop65plus,pop_total,PSU_MOS_composite,PSU_prob,SSU_MOS_composite,SSU_prob
24033800102,240338001021,320,219,72,611,3.580804885,0.097658315,0.8040566,0.224546331
24033800102,240338001022,633,385,279,1297,3.580804885,0.097658315,1.84349717,0.514827596
24033800102,240338001023,365,219,107,691,3.580804885,0.097658315,0.933251115,0.260626073
24033800103,240338001031,387,214,94,695,2.393286911,0.065271461,0.91937769,0.384148547
24033800103,240338001032,728,367,88,1183,2.393286911,0.065271461,1.473909221,0.615851453
24033800105,240338001051,414,369,190,973,4.330835357,0.118113692,1.382691482,0.319266693
24033800105,240338001052,1190,754,285,2229,4.330835357,0.118113692,2.948143875,0.680733307
24033800108,240338001061,1131,943,347,2421,7.683187731,0.209541484,3.287518463,0.427884698
24033800108,240338001081,938,489,160,1587,7.683187731,0.209541484,2.029753745,0.264181199
24033800108,240338001083,1209,505,172,1886,7.683187731,0.209541484,2.365915523,0.307934103
24033800109,240338001091,667,414,198,1279,3.879650941,0.105808662,1.729951733,0.445903964
24033800109,240338001092,429,248,163,840,3.879650941,0.105808662,1.170959161,0.301820751
24033800109,240338001093,484,220,72,776,3.879650941,0.105808662,0.978740047,0.252275285
24033800203,240338002031,711,706,518,1935,5.712312276,0.155790335,2.920079476,0.511190449
24033800203,240338002032,778,740,413,1931,5.712312276,0.155790335,2.7922328,0.488809551
24033800206,240338002061,535,491,273,1299,4.317793625,0.117758008,1.87013369,0.433122528
24033800206,240338002062,553,436,131,1120,4.317793625,0.117758008,1.48312456,0.343491303
24033800206,240338002063,557,218,34,809,4.317793625,0.117758008,0.964535375,0.223386169
24033800209,240338002091,1235,482,198,1915,4.521584369,0.123315937,2.422748519,0.535818492
24033800209,240338002092,925,399,248,1572,4.521584369,0.123315937,2.09883585,0.464181508
24033800210,240338002101,462,307,129,898,3.347389807,0.091292449,1.206794853,0.360518172
24033800210,240338002102,1142,436,146,1724,3.347389807,0.091292449,2.140594953,0.639481828
24033800211,240338002111,524,281,95,900,3.283722847,0.089556078,1.157645121,0.352540447
24033800211,240338002112,779,409,320,1508,3.283722847,0.089556078,2.126077726,0.647459553
24033800212,240338002121,1067,529,160,1756,7.710527725,0.21028712,2.220503123,0.287983287
24033800212,240338002122,524,333,743,1600,7.710527725,0.21028712,2.739824864,0.355335583
24033800212,240338002123,935,642,381,1958,7.710527725,0.21028712,2.750199738,0.35668113
24033800213,240338002131,1107,737,253,2097,5.122694682,0.139709855,2.762659742,0.539298145
24033800213,240338002132,1037,552,220,1809,5.122694682,0.139709855,2.36003494,0.460701855
24033800216,240338002161,1312,730,210,2252,4.727385715,0.128928701,2.869494647,0.606993975
24033800216,240338002162,464,436,332,1232,4.727385715,0.128928701,1.857891068,0.393006025
24033800217,240338002171,1290,656,306,2252,4.804422927,0.131029716,2.969491264,0.618074493
24033800217,240338002172,528,534,236,1298,4.804422927,0.131029716,1.834931664,0.381925507
24033800218,240338002181,257,210,71,538,5.492641051,0.149799301,0.722899117,0.131612299
24033800218,240338002182,1025,363,142,1530,5.492641051,0.149799301,1.908304675,0.347429344
24033800218,240338002183,1176,720,274,2170,5.492641051,0.149799301,2.861437258,0.520958357
24033800401,240338004011,411,437,261,1109,3.081958598,0.084053416,1.63763334,0.531361239
24033800401,240338004012,389,348,240,977,3.081958598,0.084053416,1.444325258,0.468638761
24033800402,240338004021,289,244,164,697,5.92950972,0.161713901,1.01989133,0.172002641
24033800402,240338004022,594,511,341,1446,5.92950972,0.161713901,2.118303505,0.357247666
24033800402,240338004023,433,403,229,1065,5.92950972,0.161713901,1.539991428,0.259716486
24033800402,240338004024,341,312,200,853,5.92950972,0.161713901,1.251323457,0.211033208
24033800403,240338004031,857,884,449,2190,4.422572443,0.120615612,3.155590229,0.713519172
24033800403,240338004032,340,314,206,860,4.422572443,0.120615612,1.266982214,0.286480828
24033800408,240338004081,906,837,354,2097,8.179832574,0.223086343,2.921852555,0.357202
24033800408,240338004082,676,661,409,1746,8.179832574,0.223086343,2.567632839,0.31389797
24033800408,240338004083,725,744,391,1860,8.179832574,0.223086343,2.69034718,0.32890003
24033800409,240338004091,868,922,416,2206,7.6958082,0.209885678,3.141939333,0.408266325
24033800409,240338004092,393,492,276,1161,7.6958082,0.209885678,1.728419099,0.224592279
24033800409,240338004093,812,714,427,1953,7.6958082,0.209885678,2.825449768,0.367141396
24033800410,240338004101,446,557,213,1216,7.652944567,0.20871667,1.725912591,0.225522683
24033800410,240338004102,1718,627,261,2606,7.652944567,0.20871667,3.2774095,0.428254703
24033800410,240338004103,709,409,113,1231,7.652944567,0.20871667,1.569277605,0.205055399
24033800410,240338004104,296,283,164,743,7.652944567,0.20871667,1.08034487,0.141167215
24033800411,240338004111,1284,920,467,2671,5.36241008,0.146247548,3.697823079,0.6895823
24033800411,240338004112,408,454,264,1126,5.36241008,0.146247548,1.664587001,0.3104177
24033800412,240338004121,553,456,361,1370,4.961096003,0.135302618,2.046800086,0.412570143
24033800412,240338004122,1210,645,325,2180,4.961096003,0.135302618,2.914295917,0.587429857
24033800413,240338004131,1037,481,123,1641,4.309561936,0.117533507,2.037197183,0.472715606
24033800413,240338004132,742,607,284,1633,4.309561936,0.117533507,2.272364753,0.527284394
24033800504,240338005041,588,625,421,1634,5.628391782,0.153501594,2.453645433,0.435940768
24033800504,240338005042,450,374,286,1110,5.628391782,0.153501594,1.651456885,0.29341541
24033800504,240338005043,424,396,230,1050,5.628391782,0.153501594,1.523289464,0.270643822
24033800505,240338005051,396,360,179,935,3.126635294,0.085271872,1.325767477,0.424023704
24033800505,240338005052,518,419,293,1230,3.126635294,0.085271872,1.800867817,0.575976296
24033800507,240338005071,1089,806,248,2143,7.114907713,0.194042938,2.825841752,0.397171947
24033800507,240338005072,347,462,253,1062,7.114907713,0.194042938,1.585345341,0.222820226
24033800507,240338005201,880,714,344,1938,7.114907713,0.194042938,2.703720619,0.380007827
24033800511,240338005111,577,480,201,1258,5.94590844,0.162161139,1.731619239,0.291228709
24033800511,240338005112,344,328,222,894,5.94590844,0.162161139,1.327574687,0.223275333
24033800511,240338005113,446,389,154,989,5.94590844,0.162161139,1.359749786,0.228686634
24033800511,240338005114,362,380,269,1011,5.94590844,0.162161139,1.526964728,0.256809324
24033800513,240338005131,285,285,165,735,7.227279247,0.197107616,1.073772811,0.148572205
24033800513,240338005132,420,394,275,1089,7.227279247,0.197107616,1.62130231,0.224330935
24033800513,240338005133,423,352,152,927,7.227279247,0.197107616,1.280442546,0.177167991
24033800513,240338005134,1083,918,368,2369,7.227279247,0.197107616,3.25176158,0.449928869
24033800514,240338005141,668,789,293,1750,6.818716312,0.18596499,2.462743044,0.361174
24033800514,240338005142,717,767,280,1764,6.818716312,0.18596499,2.454277708,0.359932515
24033800514,240338005143,630,641,156,1427,6.818716312,0.18596499,1.901695559,0.278893486
24033800515,240338005151,635,457,172,1264,4.872688528,0.132891505,1.693985653,0.347649074
24033800515,240338005152,916,778,494,2188,4.872688528,0.132891505,3.178702875,0.652350926
24033800516,240338005161,306,263,185,754,4.477018971,0.122100517,1.112687163,0.248533046
24033800516,240338005162,364,244,58,666,4.477018971,0.122100517,0.851913364,0.190285851
24033800516,240338005163,742,588,398,1728,4.477018971,0.122100517,2.512418444,0.561181103
24033800517,240338005171,781,901,600,2282,6.663172618,0.18172289,3.450599187,0.517861293
24033800517,240338005172,853,965,428,2246,6.663172618,0.18172289,3.212573431,0.482138707
24033800518,240338005181,433,538,354,1325,4.76058066,0.129834018,2.015203883,0.423310522
24033800518,240338005182,689,881,351,1921,4.76058066,0.129834018,2.745376776,0.576689478
24033800519,240338005191,537,642,184,1363,4.398020742,0.11994602,1.8700782,0.425209045
24033800519,240338005192,320,429,125,874,4.398020742,0.11994602,1.213361406,0.275888059
24033800519,240338005193,365,357,190,912,4.398020742,0.11994602,1.314581136,0.298902896
24033800521,240338005211,558,522,264,1344,10.02925733,0.2735252,1.915621387,0.191003314
24033800521,240338005212,367,474,902,1743,10.02925733,0.2735252,3.136578503,0.312742848
24033800521,240338005213,471,451,504,1426,10.02925733,0.2735252,2.286879414,0.228020813
24033800521,240338005214,691,748,404,1843,10.02925733,0.2735252,2.690178031,0.268233025
24033800522,240338005221,439,526,236,1201,4.238006791,0.115582003,1.729989005,0.408208172
24033800522,240338005222,716,845,258,1819,4.238006791,0.115582003,2.508017786,0.591791828
24033800605,240338006051,450,443,214,1107,5.216321901,0.142263325,1.577386835,0.302394458
24033800605,240338006052,450,549,126,1125,5.216321901,0.142263325,1.51633211,0.290689903
24033800605,240338006053,1102,507,115,1724,5.216321901,0.142263325,2.122602957,0.406915638
24033800606,240338006061,540,463,121,1124,5.002792564,0.136439797,1.482791667,0.296392794
24033800606,240338006062,900,709,165,1774,5.002792564,0.136439797,2.300543894,0.459851946
24033800606,240338006063,499,339,99,937,5.002792564,0.136439797,1.219457003,0.24375526
24033800607,240338006071,851,944,605,2400,7.254569306,0.19785189,3.594738079,0.495513645
24033800607,240338006072,337,368,243,948,7.254569306,0.19785189,1.423574575,0.196231439
24033800607,240338006073,665,702,248,1615,7.254569306,0.19785189,2.236256652,0.308254916
24033800608,240338006081,617,693,242,1552,8.159102835,0.222520986,2.159289549,0.264647914
24033800608,240338006082,2259,1961,405,4625,8.159102835,0.222520986,5.999813286,0.735352086
24033800609,240338006091,655,536,383,1574,4.228978567,0.115335779,2.314744862,0.547353179
24033800609,240338006092,576,531,250,1357,4.228978567,0.115335779,1.914233705,0.452646821
24033800701,240338007011,619,652,313,1584,9.38776972,0.256030083,2.271232031,0.241935209
24033800701,240338007012,812,867,235,1914,9.38776972,0.256030083,2.58575723,0.275438928
24033800701,240338007013,1743,1222,440,3405,9.38776972,0.256030083,4.530780459,0.482625863
24033800704,240338007041,541,512,219,1272,10.13364935,0.276372255,1.779089936,0.175562611
24033800704,240338007042,486,423,238,1147,10.13364935,0.276372255,1.644204574,0.16225197
24033800704,240338007043,972,624,166,1762,10.13364935,0.276372255,2.263335395,0.223348501
24033800704,240338007071,986,1169,778,2933,10.13364935,0.276372255,4.447019445,0.438836918
24033800705,240338007051,416,483,317,1216,4.845560677,0.132151655,1.836114165,0.378927081
24033800705,240338007052,814,954,365,2133,4.845560677,0.132151655,3.009446512,0.621072919
24033800706,240338007061,547,643,273,1463,4.525259489,0.123416168,2.089596685,0.461762843
24033800706,240338007062,674,737,309,1720,4.525259489,0.123416168,2.435662804,0.538237157
24033800800,240338008001,329,477,336,1142,4.438138084,0.12104013,1.780322884,0.401141842
24033800800,240338008002,341,374,277,992,4.438138084,0.12104013,1.515268262,0.34141981
24033800800,240338008003,223,346,187,756,4.438138084,0.12104013,1.142546938,0.257438348
24033800900,240338009001,301,342,182,825,1.969923221,0.053725179,1.207877132,0.613159497
24033800900,240338009002,155,210,134,499,1.969923221,0.053725179,0.762046089,0.386840503
24033801003,240338010031,1734,1268,358,3360,6.155031144,0.167864486,4.3925849,0.713657624
24033801003,240338010032,400,491,288,1179,6.155031144,0.167864486,1.762446243,0.286342376
24033801004,240338010041,426,441,202,1069,6.335257553,0.172779751,1.521312076,0.240134211
24033801004,240338010042,498,557,227,1282,6.335257553,0.172779751,1.813523224,0.2862588
24033801004,240338010043,845,937,357,2139,6.335257553,0.172779751,3.000422253,0.473606989
24033801005,240338010051,722,754,351,1827,4.782164732,0.130422675,2.607481938,0.545251384
24033801005,240338010052,622,685,251,1558,4.782164732,0.130422675,2.174682794,0.454748616
24033801006,240338010061,482,472,253,1207,4.328105811,0.118039249,1.741623802,0.402398619
24033801006,240338010062,736,906,247,1889,4.328105811,0.118039249,2.586482009,0.597601381
24033801106,240338011062,637,199,20,856,2.480044533,0.067637578,0.990581055,0.399420672
24033801106,240338011063,1121,188,21,1330,2.480044533,0.067637578,1.489463478,0.600579328
24033801207,240338012071,488,520,292,1300,8.768067266,0.239129107,1.904230328,0.217177888
24033801207,240338012072,924,1030,575,2529,8.768067266,0.239129107,3.718908359,0.424142316
24033801207,240338012151,917,965,370,2252,8.768067266,0.239129107,3.144928579,0.358679796
24033801208,240338012081,592,530,299,1421,4.966869884,0.135460088,2.044073778,0.41154164
24033801208,240338012082,828,876,367,2071,4.966869884,0.135460088,2.922796106,0.58845836
24033801209,240338012091,890,831,344,2065,5.064578352,0.138124864,2.873455914,0.567363305
24033801209,240338012092,591,560,345,1496,5.064578352,0.138124864,2.191122439,0.432636695
24033801210,240338012101,647,628,492,1767,5.21297048,0.142171922,2.685685849,0.51519299
24033801210,240338012102,638,630,427,1695,5.21297048,0.142171922,2.527284631,0.48480701
24033801211,240338012111,522,462,303,1287,3.831145074,0.104485775,1.886917089,0.492520396
24033801211,240338012112,556,476,304,1336,3.831145074,0.104485775,1.944227985,0.507479604
24033801212,240338012121,407,355,267,1029,4.030180447,0.109914012,1.535847942,0.381086644
24033801212,240338012122,655,596,425,1676,4.030180447,0.109914012,2.494332505,0.618913356
24033801213,240338012131,366,330,281,977,4.603122063,0.125539693,1.491161722,0.323945727
24033801213,240338012132,867,731,515,2113,4.603122063,0.125539693,3.111960341,0.676054273
24033801214,240338012141,554,416,251,1221,5.095062941,0.138956262,1.736869504,0.340892649
24033801214,240338012142,734,765,661,2160,5.095062941,0.138956262,3.358193436,0.659107351
24033801216,240338012161,361,362,240,963,4.49575289,0.122611442,1.43377912,0.318918578
24033801216,240338012162,830,723,515,2068,4.49575289,0.122611442,3.06197377,0.681081422
24033801217,240338012171,472,404,207,1083,4.850402636,0.132283708,1.531254609,0.315696391
24033801217,240338012172,771,819,596,2186,4.850402636,0.132283708,3.319148027,0.684303609
24033801302,240338013021,545,572,375,1492,3.489700086,0.095173639,2.228806264,0.638681322
24033801302,240338013022,273,341,218,832,3.489700086,0.095173639,1.260893822,0.361318678
24033801305,240338013051,835,781,458,2074,7.400933801,0.201843649,3.01321057,0.407139241
24033801305,240338013052,774,667,469,1910,7.400933801,0.201843649,2.819314378,0.380940359
24033801305,240338013053,422,393,252,1067,7.400933801,0.201843649,1.568408853,0.2119204
24033801307,240338013071,512,637,721,1870,5.056766867,0.137911824,3.089390047,0.610941759
24033801307,240338013072,476,406,391,1273,5.056766867,0.137911824,1.96737682,0.389058241
24033801308,240338013081,595,518,358,1471,4.515311087,0.123144848,2.168535102,0.480262613
24033801308,240338013082,586,572,407,1565,4.515311087,0.123144848,2.346775986,0.519737387
24033801309,240338013091,394,540,497,1431,4.664425265,0.127211598,2.310250469,0.495291561
24033801309,240338013092,616,621,368,1605,4.664425265,0.127211598,2.354174795,0.504708439
24033801310,240338013101,915,1058,375,2348,7.949847688,0.216814028,3.280994433,0.412711609
24033801310,240338013102,299,402,155,856,7.949847688,0.216814028,1.224410822,0.154016891
24033801310,240338013103,958,963,481,2402,7.949847688,0.216814028,3.444442432,0.4332715
24033801311,240338013111,703,735,477,1915,9.119512594,0.24871398,2.85544513,0.313113788
24033801311,240338013112,632,674,328,1634,9.119512594,0.24871398,2.349886868,0.257676805
24033801311,240338013113,1381,1206,349,2936,9.119512594,0.24871398,3.914180595,0.429209407
24033801312,240338013121,517,376,282,1175,4.771557081,0.130133375,1.715656621,0.359559069
24033801312,240338013122,738,742,543,2023,4.771557081,0.130133375,3.05590046,0.640440931
24033801313,240338013131,460,429,374,1263,3.936749764,0.107365903,1.94210451,0.493326888
24033801313,240338013132,550,468,333,1351,3.936749764,0.107365903,1.994645254,0.506673112
24033801404,240338014041,1338,1255,586,3179,7.759393364,0.211619819,4.48819054,0.578420287
24033801404,240338014042,484,355,113,952,7.759393364,0.211619819,1.258025233,0.162129328
24033801404,240338014043,617,421,338,1376,7.759393364,0.211619819,2.013177591,0.259450384
24033801405,240338014051,1097,574,308,1979,5.080571337,0.138561036,2.658631753,0.523293854
24033801405,240338014052,782,571,351,1704,5.080571337,0.138561036,2.421939584,0.476706146
24033801406,240338014061,347,264,334,945,3.691983108,0.100690448,1.504915981,0.407617244
24033801406,240338014062,868,539,230,1637,3.691983108,0.100690448,2.187067127,0.592382756
24033801407,240338014071,425,371,273,1069,7.715781545,0.210430406,1.590632411,0.206153116
24033801407,240338014072,1076,770,452,2298,7.715781545,0.210430406,3.238951694,0.419782711
24033801407,240338014073,797,628,510,1935,7.715781545,0.210430406,2.88619744,0.374064173
24033801408,240338014081,763,531,223,1517,3.716244177,0.101352114,2.04888763,0.551332887
24033801408,240338014082,541,363,258,1162,3.716244177,0.101352114,1.667356547,0.448667113
24033801409,240338014091,646,524,405,1575,3.218141558,0.087767497,2.340222715,0.727196946
24033801409,240338014092,233,178,167,578,3.218141558,0.087767497,0.877918844,0.272803054
24033801410,240338014101,496,495,405,1396,4.223240726,0.115179293,2.142243934,0.507251202
24033801410,240338014102,562,457,371,1390,4.223240726,0.115179293,2.080996792,0.492748798
24033801411,240338014111,515,443,280,1238,3.978626337,0.108507991,1.800024799,0.452423688
24033801411,240338014112,558,549,361,1468,3.978626337,0.108507991,2.178601538,0.547576312
24033801500,240338015001,374,286,224,884,3.044965575,0.083044516,1.306808252,0.429170123
24033801500,240338015002,560,414,250,1224,3.044965575,0.083044516,1.738157323,0.570829877
24033801600,240338016001,492,199,127,818,3.029335125,0.082618231,1.086912139,0.358795608
24033801600,240338016002,356,176,126,658,3.029335125,0.082618231,0.909559161,0.300250426
24033801600,240338016003,469,208,109,786,3.029335125,0.082618231,1.032863825,0.340953966
24033801701,240338017011,1111,595,206,1912,4.615919538,0.125888715,2.464084341,0.533823071
24033801701,240338017012,618,493,355,1466,4.615919538,0.125888715,2.151835196,0.466176929
24033801702,240338017021,309,234,188,731,3.972379598,0.108337625,1.083403505,0.272734133
24033801702,240338017022,770,360,104,1234,3.972379598,0.108337625,1.54609351,0.389210918
24033801702,240338017023,579,323,125,1027,3.972379598,0.108337625,1.342882583,0.338054949
24033801704,240338017041,587,359,151,1097,5.784206593,0.157751089,1.460955926,0.252576719
24033801704,240338017042,1048,518,140,1706,5.784206593,0.157751089,2.138809262,0.369767094
24033801704,240338017043,645,544,327,1516,5.784206593,0.157751089,2.184441405,0.377656187
24033801707,240338017071,1061,418,160,1639,6.715406861,0.18314746,2.06315762,0.307227494
24033801707,240338017072,1066,409,199,1674,6.715406861,0.18314746,2.147164491,0.319737067
24033801707,240338017073,811,493,419,1723,6.715406861,0.18314746,2.50508475,0.37303544
24033801709,240338017091,861,524,129,1514,5.921131527,0.161485405,1.923683973,0.32488452
24033801709,240338017092,767,491,252,1510,5.921131527,0.161485405,2.066340573,0.348977313
24033801709,240338017093,335,229,208,772,5.921131527,0.161485405,1.150728898,0.194342736
24033801709,240338017094,222,192,122,536,5.921131527,0.161485405,0.780378082,0.131795431
24033801802,240338018021,313,166,89,568,4.378299517,0.119408169,0.764209405,0.174544798
24033801802,240338018022,758,489,238,1485,4.378299517,0.119408169,2.021453597,0.461698335
24033801802,240338018023,444,368,267,1079,4.378299517,0.119408169,1.592636514,0.363756867
24033801807,240338018071,617,286,125,1028,5.200706438,0.141837448,1.332707997,0.256255186
24033801807,240338018072,745,604,411,1760,5.200706438,0.141837448,2.567677467,0.493717055
24033801807,240338018073,364,289,224,877,5.200706438,0.141837448,1.300320974,0.250027759
24033801808,240338018081,381,268,155,804,4.076751704,0.111184137,1.128778727,0.276881893
24033801808,240338018082,320,187,174,681,4.076751704,0.111184137,0.99843548,0.244909563
24033801808,240338018083,790,473,202,1465,4.076751704,0.111184137,1.949537496,0.478208544
24033801809,240338018091,304,256,209,769,4.994940926,0.136225662,1.157029886,0.231640354
24033801809,240338018092,477,386,333,1196,4.994940926,0.136225662,1.80594255,0.361554336
24033801809,240338018093,90,65,64,219,4.994940926,0.136225662,0.332820235,0.066631466
24033801809,240338018094,643,398,205,1246,4.994940926,0.136225662,1.699148255,0.340173844
24033801901,240338019011,268,240,179,687,6.193284244,0.168907752,1.027242937,0.165864006
24033801901,240338019012,491,430,331,1252,6.193284244,0.168907752,1.875931091,0.302897625
24033801901,240338019013,389,285,272,946,6.193284244,0.168907752,1.433259009,0.231421481
24033801901,240338019014,477,468,307,1252,6.193284244,0.168907752,1.856851207,0.299816888
24033801904,240338019041,929,489,222,1640,3.808363825,0.103864468,2.164855099,0.568447553
24033801904,240338019042,416,398,284,1098,3.808363825,0.103864468,1.643508726,0.431552447
24033801905,240338019051,498,456,346,1300,7.578313793,0.206681285,1.953686442,0.257799623
24033801905,240338019052,2520,1359,477,4356,7.578313793,0.206681285,5.624627351,0.742200377
24033801906,240338019061,542,341,116,999,2.410288055,0.065735129,1.307274208,0.542372604
24033801906,240338019062,350,268,158,776,2.410288055,0.065735129,1.103013847,0.457627396
24033801907,240338018011,840,482,221,1543,6.770727615,0.184656208,2.058940372,0.304094403
24033801907,240338019071,334,245,191,770,6.770727615,0.184656208,1.131786505,0.167158771
24033801907,240338019072,256,257,343,856,6.770727615,0.184656208,1.420212234,0.209757697
24033801907,240338019073,540,472,406,1418,6.770727615,0.184656208,2.159788503,0.318989129
24033801908,240338019081,1057,584,261,1902,3.758341578,0.102500225,2.520335868,0.670597873
24033801908,240338019082,532,339,92,963,3.758341578,0.102500225,1.23800571,0.329402127
24033802001,240338020011,680,429,131,1240,5.633388726,0.153637874,1.607821435,0.285409283
24033802001,240338020012,992,510,215,1717,5.633388726,0.153637874,2.243677644,0.398282056
24033802001,240338020013,624,405,245,1274,5.633388726,0.153637874,1.781889647,0.316308661
24033802002,240338020021,202,85,48,335,4.117754942,0.112302408,0.441075716,0.107115582
24033802002,240338020022,535,426,186,1147,4.117754942,0.112302408,1.578783009,0.383408685
24033802002,240338020023,307,189,210,706,4.117754942,0.112302408,1.071386088,0.260186947
24033802002,240338020024,296,252,159,707,4.117754942,0.112302408,1.026510128,0.249288785
24033802103,240338021031,474,497,309,1280,3.642389968,0.099337908,1.897797202,0.521030757
24033802103,240338021032,581,483,203,1267,3.642389968,0.099337908,1.744592766,0.478969243
24033802104,240338021041,333,263,146,742,2.552101895,0.069602779,1.050255823,0.411525819
24033802104,240338021042,437,401,212,1050,2.552101895,0.069602779,1.501846072,0.588474181
24033802106,240338021061,486,197,66,749,4.475875638,0.122069336,0.935569734,0.209024962
24033802106,240338021062,1114,663,145,1922,4.475875638,0.122069336,2.417481577,0.540113661
24033802106,240338021063,311,294,169,774,4.475875638,0.122069336,1.122824327,0.250861377
24033802107,240338021071,334,235,127,696,3.673649616,0.100190444,0.968904584,0.263744419
24033802107,240338021072,625,261,64,950,3.673649616,0.100190444,1.164872259,0.317088558
24033802107,240338021073,428,204,44,676,3.673649616,0.100190444,0.832481076,0.22660873
24033802107,240338021074,342,160,55,557,3.673649616,0.100190444,0.707391697,0.192558292
24033802203,240338022031,770,581,282,1633,5.409320104,0.147526912,2.261921154,0.418152579
24033802203,240338022032,441,357,234,1032,5.409320104,0.147526912,1.497530142,0.276842582
24033802203,240338022033,381,375,316,1072,5.409320104,0.147526912,1.649868808,0.305004839
24033802204,240338022041,605,483,375,1463,7.180161109,0.195822576,2.171141523,0.302380614
24033802204,240338022042,400,340,269,1009,7.180161109,0.195822576,1.51270894,0.210678969
24033802204,240338022043,575,516,318,1409,7.180161109,0.195822576,2.051378645,0.285700921
24033802204,240338022044,506,381,168,1055,7.180161109,0.195822576,1.444932001,0.201239496
24033802301,240338023011,490,407,277,1174,4.357179241,0.118832161,1.717631796,0.394207284
24033802301,240338023012,401,296,278,975,4.357179241,0.118832161,1.47490039,0.338498902
24033802301,240338023013,364,299,160,823,4.357179241,0.118832161,1.164647056,0.267293814
24033802404,240338024041,516,203,65,784,4.517125907,0.123194343,0.973105103,0.215425721
24033802404,240338024042,395,250,101,746,4.517125907,0.123194343,0.99313415,0.219859745
24033802404,240338024043,950,621,301,1872,4.517125907,0.123194343,2.550886654,0.564714534
24033802405,240338024051,662,571,410,1643,4.415581781,0.120424958,2.432733424,0.550942898
24033802405,240338024052,784,473,219,1476,4.415581781,0.120424958,1.982848357,0.449057102
24033802406,240338024061,486,292,226,1004,2.566918816,0.070006877,1.438002546,0.560205698
24033802406,240338024062,481,283,101,865,2.566918816,0.070006877,1.128916269,0.439794302
24033802407,240338024071,637,445,257,1339,4.116013775,0.112254921,1.878034284,0.456275024
24033802407,240338024072,772,627,244,1643,4.116013775,0.112254921,2.237979491,0.543724976
24033802408,240338024081,594,442,328,1364,2.749802089,0.074994602,1.994113819,0.725184487
24033802408,240338024082,302,194,74,570,2.749802089,0.074994602,0.75568827,0.274815513
24033802501,240338025011,614,442,227,1283,3.560801527,0.097112769,1.779671559,0.499795213
24033802501,240338025012,638,433,222,1293,3.560801527,0.097112769,1.781129968,0.500204787
24033802502,240338025021,343,253,154,750,2.572481386,0.070158583,1.06588004,0.414339262
24033802502,240338025022,486,363,214,1063,2.572481386,0.070158583,1.506601346,0.585660738
24033802600,240338026001,679,454,244,1377,3.513328771,0.095818057,1.904343418,0.542033935
24033802600,240338026002,577,407,191,1175,3.513328771,0.095818057,1.608985354,0.457966065
24033802700,240338027001,346,247,112,705,2.975872042,0.081160147,0.962924548,0.323577269
24033802700,240338027002,307,228,198,733,2.975872042,0.081160147,1.096452083,0.368447322
24033802700,240338027003,328,244,102,674,2.975872042,0.081160147,0.916495411,0.30797541
24033802803,240338028031,889,586,224,1699,6.336893959,0.172824381,2.259204933,0.356516134
24033802803,240338028032,843,615,271,1729,6.336893959,0.172824381,2.359667509,0.372369733
24033802803,240338028033,579,321,287,1187,6.336893959,0.172824381,1.718021517,0.271114134
24033802804,240338028041,478,319,300,1097,6.258507365,0.170686564,1.638881162,0.261864542
24033802804,240338028042,734,457,236,1427,6.258507365,0.170686564,1.94789151,0.31123899
24033802804,240338028043,787,617,429,1833,6.258507365,0.170686564,2.671734693,0.426896469
24033802805,240338028051,537,334,231,1102,5.655426049,0.154238892,1.56070093,0.275965226
24033802805,240338028052,547,292,190,1029,5.655426049,0.154238892,1.418501435,0.250821321
24033802805,240338028053,801,642,410,1853,5.655426049,0.154238892,2.676223684,0.473213452
24033802901,240338029011,587,328,202,1117,4.393958429,0.11983523,1.537739364,0.349966753
24033802901,240338029012,410,326,190,926,4.393958429,0.11983523,1.319966885,0.300404955
24033802901,240338029013,510,313,245,1068,4.393958429,0.11983523,1.53625218,0.349628292
24033803001,240338030011,576,402,229,1207,3.320336031,0.090554619,1.68976027,0.508912428
24033803001,240338030012,504,411,231,1146,3.320336031,0.090554619,1.630575761,0.491087572
24033803002,240338030021,576,455,227,1258,3.034346907,0.082754916,1.757196542,0.579102059
24033803002,240338030022,423,293,185,901,3.034346907,0.082754916,1.277150365,0.420897941
24033803100,240338031001,408,270,178,856,2.892824215,0.078895206,1.213681172,0.419548884
24033803100,240338031002,625,447,176,1248,2.892824215,0.078895206,1.679143043,0.580451116
24033803200,240338032001,722,375,182,1279,2.91186899,0.079414609,1.69770328,0.58302873
24033803200,240338032002,567,296,91,954,2.91186899,0.079414609,1.214165711,0.41697127
24033803300,240338033001,576,333,184,1093,5.110419734,0.139375084,1.490931623,0.291743477
24033803300,240338033002,568,330,165,1063,5.110419734,0.139375084,1.434078758,0.280618586
24033803300,240338033003,321,230,102,653,5.110419734,0.139375084,0.890051874,0.174164143
24033803300,240338033004,452,301,175,928,5.110419734,0.139375084,1.295357479,0.253473794
24033803403,240338034031,911,599,239,1749,6.335671,0.172791027,2.3351278,0.368568349
24033803403,240338034032,396,275,240,911,6.335671,0.172791027,1.352413983,0.213460261
24033803403,240338034033,267,164,97,528,6.335671,0.172791027,0.731533344,0.115462647
24033803403,240338034034,663,424,274,1361,6.335671,0.172791027,1.916595873,0.302508743
24033803508,240338035081,388,282,215,885,3.777960672,0.103035291,1.295170314,0.342822604
24033803508,240338035082,547,338,227,1112,3.777960672,0.103035291,1.567381139,0.414874922
24033803508,240338035083,505,224,33,762,3.777960672,0.103035291,0.91540922,0.242302475
24033803509,240338035091,1026,401,154,1581,3.472755195,0.094711505,1.989046338,0.572757429
24033803509,240338035092,898,285,63,1246,3.472755195,0.094711505,1.483708856,0.427242571
24033803512,240338022011,1861,1002,392,3255,11.98477768,0.326857573,4.244242035,0.354136067
24033803512,240338035121,1120,953,463,2536,11.98477768,0.326857573,3.560063367,0.297048761
24033803512,240338035122,729,643,576,1948,11.98477768,0.326857573,2.988680643,0.249373057
24033803512,240338035123,608,330,43,981,11.98477768,0.326857573,1.191791638,0.099442115
24033803513,240338035131,546,357,123,1026,5.499485165,0.149985959,1.349595274,0.24540393
24033803513,240338035132,548,438,195,1181,5.499485165,0.149985959,1.62983904,0.296362112
24033803513,240338035133,770,565,402,1737,5.499485165,0.149985959,2.520050851,0.458233957
24033803514,240338035141,793,697,236,1726,6.05096578,0.165026339,2.336741565,0.386176629
24033803514,240338035142,508,392,231,1131,6.05096578,0.165026339,1.60895555,0.26590062
24033803514,240338035143,1145,490,98,1733,6.05096578,0.165026339,2.105268665,0.347922752
24033803516,240338035161,316,265,260,841,5.39882956,0.147240806,1.300911504,0.240961766
24033803516,240338035162,493,492,148,1133,5.39882956,0.147240806,1.535548044,0.284422397
24033803516,240338035163,811,758,289,1858,5.39882956,0.147240806,2.562370012,0.474615837
24033803519,240338035191,1129,591,274,1994,6.705151924,0.18286778,2.636273792,0.393171374
24033803519,240338035192,292,217,306,815,6.705151924,0.18286778,1.317541454,0.196496883
24033803519,240338035193,1296,635,222,2153,6.705151924,0.18286778,2.751336678,0.410331743
24033803520,240338035201,318,358,321,997,5.563180292,0.151723099,1.571822929,0.282540354
24033803520,240338035202,386,369,310,1065,5.563180292,0.151723099,1.632995842,0.293536387
24033803520,240338035203,546,483,482,1511,5.563180292,0.151723099,2.358361521,0.423923259
24033803521,240338035211,1646,1295,603,3544,8.729378942,0.238073971,4.907767629,0.562212691
24033803521,240338035212,707,782,862,2351,8.729378942,0.238073971,3.821611313,0.437787309
24033803524,240338035241,859,633,307,1799,4.710782428,0.128475884,2.485033106,0.527520246
24033803524,240338035242,1067,538,157,1762,4.710782428,0.128475884,2.225749321,0.472479754
24033803525,240338035251,298,195,62,555,2.38912855,0.065158051,0.724831669,0.303387471
24033803525,240338035252,704,373,177,1254,2.38912855,0.065158051,1.664296881,0.696612529
24033803526,240338035261,607,617,342,1566,4.040374543,0.110192033,2.278577409,0.563952026
24033803526,240338035262,518,428,271,1217,4.040374543,0.110192033,1.761797133,0.436047974
24033803527,240338035271,580,475,324,1379,3.537053518,0.096465096,2.014881283,0.569649646
24033803527,240338035272,436,391,227,1054,3.537053518,0.096465096,1.522172235,0.430350354
24033803528,240338035281,384,404,439,1227,8.893091168,0.24253885,1.979384457,0.222575527
24033803528,240338035282,732,677,502,1911,8.893091168,0.24253885,2.865502197,0.322216667
24033803528,240338035283,380,335,218,933,8.893091168,0.24253885,1.365814141,0.153581484
24033803528,240338035284,787,786,335,1908,8.893091168,0.24253885,2.682390372,0.301626321
24033803601,240338036011,853,760,459,2072,4.176188011,0.113896037,3.005997896,0.719794676
24033803601,240338036012,317,235,221,773,4.176188011,0.113896037,1.170190115,0.280205324
24033803602,240338036021,392,276,166,834,2.268853542,0.061877824,1.176944397,0.518739696
24033803602,240338036022,377,208,176,761,2.268853542,0.061877824,1.091909145,0.481260304
24033803605,240338036051,823,563,268,1654,7.613090271,0.207629735,2.260792342,0.296961189
24033803605,240338036052,945,650,324,1919,7.613090271,0.207629735,2.638700771,0.346600484
24033803605,240338036053,1188,578,288,2054,7.613090271,0.207629735,2.713597158,0.356438327
24033803606,240338036061,623,426,291,1340,6.516523092,0.177723357,1.916694707,0.29412843
24033803606,240338036062,489,336,194,1019,6.516523092,0.177723357,1.426391736,0.218888465
24033803606,240338036063,520,377,212,1109,6.516523092,0.177723357,1.55691484,0.238918027
24033803606,240338036064,613,376,196,1185,6.516523092,0.177723357,1.616521809,0.248065078
24033803607,240338036071,401,255,95,751,4.008739369,0.109329256,0.992282433,0.247529795
24033803607,240338036072,873,699,490,2062,4.008739369,0.109329256,3.016456937,0.752470205
24033803608,240338036081,474,318,177,969,6.770000362,0.184636374,1.346399869,0.19887737
24033803608,240338036082,628,540,335,1503,6.770000362,0.184636374,2.179693131,0.321963518
24033803608,240338036083,1212,740,410,2362,6.770000362,0.184636374,3.243907362,0.479159112
24033803610,240338036101,799,500,323,1622,3.717964341,0.101399027,2.278008497,0.612703159
24033803610,240338036102,532,352,171,1055,3.717964341,0.101399027,1.439955843,0.387296841
24033803612,240338036121,932,424,187,1543,3.779442346,0.1030757,1.997963271,0.528639701
24033803612,240338036122,816,463,124,1403,3.779442346,0.1030757,1.781479075,0.471360299
24033803613,240338036131,1240,648,340,2228,6.750177779,0.184095758,2.985069565,0.442220881
24033803613,240338036132,834,510,208,1552,6.750177779,0.184095758,2.060368412,0.305231726
24033803613,240338036133,830,394,125,1349,6.750177779,0.184095758,1.704739802,0.252547393
24033803700,240338037001,647,336,166,1149,2.791178418,0.076123048,1.528064606,0.547462174
24033803700,240338037002,514,296,136,946,2.791178418,0.076123048,1.263113812,0.452537826
24033803803,240338038011,1105,658,322,2085,8.584505581,0.234122879,2.814014692,0.327801603
24033803803,240338038031,1061,524,198,1783,8.584505581,0.234122879,2.2959938,0.267457896
24033803803,240338038032,1309,817,420,2546,8.584505581,0.234122879,3.474497089,0.404740501
24033803900,240338039001,927,381,134,1442,4.158234301,0.11340639,1.810561049,0.435415832
24033803900,240338039002,526,188,62,776,4.158234301,0.11340639,0.956270177,0.229970249
24033803900,240338039003,617,312,135,1064,4.158234301,0.11340639,1.391403075,0.334613919
24033804001,240338040011,1209,695,240,2144,5.266166552,0.143622724,2.782999339,0.528467779
24033804001,240338040012,999,456,346,1801,5.266166552,0.143622724,2.483167213,0.471532221
24033804002,240338040021,727,439,207,1373,4.283656782,0.116827003,1.848364815,0.431492276
24033804002,240338040022,1138,534,217,1889,4.283656782,0.116827003,2.435291967,0.568507724
24033804101,240338041011,548,349,216,1113,3.3230558,0.090628795,1.557745246,0.46876891
24033804101,240338041012,708,427,187,1322,3.3230558,0.090628795,1.765310554,0.53123109
24033804102,240338041021,769,443,230,1442,6.650499747,0.181377266,1.951840777,0.293487836
24033804102,240338041022,1130,660,230,2020,6.650499747,0.181377266,2.628569679,0.395243933
24033804102,240338041023,914,479,194,1587,6.650499747,0.181377266,2.07008929,0.311268231
24033804200,240338042001,244,204,119,567,3.472425298,0.094702508,0.812956134,0.234117674
24033804200,240338042002,412,288,263,963,3.472425298,0.094702508,1.440655503,0.41488452
24033804200,240338042003,361,312,177,850,3.472425298,0.094702508,1.218813661,0.350997806
24033804300,240338043001,618,310,217,1145,3.662001488,0.099872768,1.581001457,0.431731517
24033804300,240338043002,871,541,182,1594,3.662001488,0.099872768,2.081000031,0.568268483
24033804400,240338044001,644,367,162,1173,3.051999832,0.083236359,1.557736597,0.510398651
24033804400,240338044002,478,343,224,1045,3.051999832,0.083236359,1.494263236,0.489601349
24033804600,240338046001,834,529,301,1664,3.748229793,0.102224449,2.303135491,0.614459523
24033804600,240338046002,693,313,123,1129,3.748229793,0.102224449,1.445094302,0.385540477
24033804700,240338047001,570,373,201,1144,3.898904352,0.106333755,1.578658489,0.404897978
24033804700,240338047002,497,311,149,957,3.898904352,0.106333755,1.295875478,0.332369138
24033804700,240338047003,408,232,119,759,3.898904352,0.106333755,1.024370384,0.262732884
24033804801,240338048011,518,200,56,774,2.583457701,0.070457937,0.950145391,0.36778051
24033804801,240338048012,472,223,68,763,2.583457701,0.070457937,0.960809203,0.371908239
24033804801,240338048013,334,156,46,536,2.583457701,0.070457937,0.672503106,0.260311251
24033804802,240338048021,820,249,92,1161,2.847492742,0.077658893,1.419941877,0.498663914
24033804802,240338048022,571,232,218,1021,2.847492742,0.077658893,1.427550865,0.501336086
24033804900,240338049001,564,362,461,1387,4.703614954,0.128280408,2.163794549,0.460027993
24033804900,240338049002,950,558,333,1841,4.703614954,0.128280408,2.539820405,0.539972007
24033805000,240338050001,376,228,170,774,6.445899131,0.175797249,1.104065495,0.171281845
24033805000,240338050002,756,427,503,1686,6.445899131,0.175797249,2.553098979,0.396081125
24033805000,240338050003,1411,520,253,2184,6.445899131,0.175797249,2.788734657,0.43263703
24033805101,240338051011,1003,498,189,1690,3.554416626,0.096938635,2.178334014,0.612852753
24033805101,240338051012,878,254,44,1176,3.554416626,0.096938635,1.376082613,0.387147247
24033805201,240338052011,732,389,252,1373,4.351414264,0.118674934,1.890590084,0.434477154
24033805201,240338052012,1013,523,291,1827,4.351414264,0.118674934,2.46082418,0.565522846
24033805202,240338052021,663,416,318,1397,3.891126781,0.106121639,2.008341241,0.516133592
24033805202,240338052022,461,234,34,729,3.891126781,0.106121639,0.884844384,0.227400553
24033805202,240338052023,527,235,52,814,3.891126781,0.106121639,0.997941156,0.256465855
24033805500,240338055001,826,478,283,1587,3.622868929,0.098805516,2.183315886,0.602648324
24033805500,240338055002,797,295,84,1176,3.622868929,0.098805516,1.439553043,0.397351676
24033805601,240338056011,1091,268,41,1400,5.089880857,0.138814932,1.613239403,0.316950327
24033805601,240338056012,906,274,24,1204,5.089880857,0.138814932,1.386233005,0.272350777
24033805601,240338056013,1265,415,81,1761,5.089880857,0.138814932,2.090408448,0.410698896
24033805602,240338056021,667,244,100,1011,4.400610156,0.120016641,1.270101896,0.288619498
24033805602,240338056022,1109,263,49,1421,4.400610156,0.120016641,1.644120404,0.373611919
24033805602,240338056023,1094,205,22,1321,4.400610156,0.120016641,1.486387856,0.337768583
24033805700,240338057001,842,409,204,1455,6.261403068,0.170765538,1.922092911,0.306974793
24033805700,240338057002,918,461,182,1561,6.261403068,0.170765538,2.021839869,0.322905241
24033805700,240338057003,1245,486,146,1877,6.261403068,0.170765538,2.317470288,0.370119966
24033805801,240338058011,1191,626,310,2127,4.82770081,0.131664568,2.833381193,0.586900743
24033805801,240338058012,736,469,248,1453,4.82770081,0.131664568,1.994319617,0.413099257
24033805802,240338058021,1139,594,332,2065,4.328110539,0.118039378,2.786206585,0.643746633
24033805802,240338058022,691,372,131,1194,4.328110539,0.118039378,1.541903954,0.356253367
24033805904,240338059041,549,301,216,1066,4.13612101,0.1128033,1.493502887,0.361087812
24033805904,240338059042,984,554,364,1902,4.13612101,0.1128033,2.642618123,0.638912188
24033805906,240338059061,1092,448,211,1751,3.389949201,0.09245316,2.25568775,0.665404587
24033805906,240338059062,818,140,34,992,3.389949201,0.09245316,1.134261452,0.334595413
24033805907,240338059071,786,461,192,1439,3.276197405,0.089350838,1.905660628,0.581668438
24033805907,240338059072,671,277,122,1070,3.276197405,0.089350838,1.370536776,0.418331562
24033805909,240338059081,2090,601,196,2887,24.19409543,0.659838966,3.483576108,0.143984557
24033805909,240338059091,1104,215,152,1471,24.19409543,0.659838966,1.81378111,0.074967924
24033805909,240338059092,1867,546,152,2565,24.19409543,0.659838966,3.070448461,0.126909
24033805909,240339800001,14342,250,141,14733,24.19409543,0.659838966,15.82628975,0.654138519
24033806000,240338060001,1778,656,304,2738,6.210838885,0.169386515,3.480568077,0.560402249
24033806000,240338060002,630,267,74,971,6.210838885,0.169386515,1.201643574,0.193475245
24033806000,240338060003,761,289,142,1192,6.210838885,0.169386515,1.528627234,0.246122507
24033806100,240338061001,692,466,405,1563,5.112532917,0.139432716,2.309934508,0.451818022
24033806100,240338061002,713,418,205,1336,5.112532917,0.139432716,1.800335607,0.352141617
24033806100,240338061003,372,230,127,729,5.112532917,0.139432716,1.002262802,0.196040362
24033806400,240338064001,1026,315,237,1578,4.552300704,0.124153656,2.065646729,0.453758849
24033806400,240338064002,452,366,281,1099,4.552300704,0.124153656,1.631025042,0.358285875
24033806400,240338064003,227,228,131,586,4.552300704,0.124153656,0.855628934,0.187955276
24033806501,240338065011,806,500,334,1640,4.851036908,0.132301007,2.311063575,0.4764061
24033806501,240338065012,533,214,39,786,4.851036908,0.132301007,0.945391763,0.194884471
24033806501,240338065013,938,356,51,1345,4.851036908,0.132301007,1.59458157,0.328709429
24033806601,240338066011,571,331,104,1006,4.233478358,0.115458501,1.296329184,0.306209002
24033806601,240338066012,583,341,153,1077,4.233478358,0.115458501,1.436906267,0.33941505
24033806601,240338066013,969,266,49,1284,4.233478358,0.115458501,1.500242906,0.354375948
24033806602,240338066021,1305,527,194,2026,5.21380185,0.142194596,2.548616004,0.488821033
24033806602,240338066022,429,226,109,764,5.21380185,0.142194596,1.015077113,0.19469039
24033806602,240338066023,736,360,164,1260,5.21380185,0.142194596,1.650108733,0.316488578
24033806706,240338067061,721,349,276,1346,4.795973552,0.130799279,1.880527973,0.392105576
24033806706,240338067062,357,272,195,824,4.795973552,0.130799279,1.202154679,0.250659155
24033806706,240338067063,519,419,255,1193,4.795973552,0.130799279,1.7132909,0.357235269
24033806708,240338067081,273,304,288,865,5.156135988,0.140621891,1.373831741,0.266445987
24033806708,240338067082,567,420,306,1293,5.156135988,0.140621891,1.884335839,0.365455031
24033806708,240338067083,482,217,100,799,5.156135988,0.140621891,1.037854241,0.201285273
24033806708,240338067084,250,210,133,593,5.156135988,0.140621891,0.860114167,0.166813709
24033806710,240338067101,371,290,134,795,5.968384329,0.162774118,1.099157234,0.18416328
24033806710,240338067102,726,619,342,1687,5.968384329,0.162774118,2.407063103,0.403302296
24033806710,240338067103,580,379,139,1098,5.968384329,0.162774118,1.452776384,0.243412003
24033806710,240338067104,305,277,133,715,5.968384329,0.162774118,1.009387607,0.169122421
24033806711,240338067111,307,235,145,687,4.907540052,0.133842001,0.982354107,0.200172408
24033806711,240338067112,363,204,154,721,4.907540052,0.133842001,1.02035739,0.207916263
24033806711,240338067113,111,72,37,220,4.907540052,0.133842001,0.301560218,0.061448346
24033806711,240338067114,1086,595,277,1958,4.907540052,0.133842001,2.603268337,0.530462983
24033806712,240338067121,712,469,151,1332,3.463847021,0.094468555,1.742705922,0.503112843
24033806712,240338067122,616,442,201,1259,3.463847021,0.094468555,1.7211411,0.496887157
24033806713,240338067131,598,211,49,858,3.334077823,0.090929395,1.033330348,0.309929882
24033806713,240338067132,506,176,34,716,3.334077823,0.090929395,0.853499329,0.255992623
24033806713,240338067133,819,323,61,1203,3.334077823,0.090929395,1.447248147,0.434077494
24033806714,240338067141,1065,421,75,1561,4.863858264,0.13265068,1.873206475,0.385127685
24033806714,240338067142,1964,496,103,2563,4.863858264,0.13265068,2.990651788,0.614872315
24033806800,240338068001,761,371,206,1338,4.497992953,0.122672535,1.789457965,0.397834764
24033806800,240338068002,613,401,217,1231,4.497992953,0.122672535,1.69951363,0.377838215
24033806800,240338068003,312,225,160,697,4.497992953,0.122672535,1.009021358,0.224327021
24033806900,240338069001,803,437,217,1457,4.621135723,0.126030974,1.949289126,0.421820358
24033806900,240338069002,669,351,183,1203,4.621135723,0.126030974,1.611373208,0.34869636
24033806900,240338069003,492,219,104,815,4.621135723,0.126030974,1.060473389,0.229483281
24033807000,240338070001,475,174,135,784,9.966135238,0.271803688,1.053595462,0.105717556
24033807000,240338070002,927,209,82,1218,9.966135238,0.271803688,1.455283916,0.146022895
24033807000,240338070003,490,159,78,727,9.966135238,0.271803688,0.916091531,0.091920439
24033807000,240338070004,532,202,144,878,9.966135238,0.271803688,1.172919201,0.117690476
24033807000,240338070005,4308,229,216,4753,9.966135238,0.271803688,5.368245129,0.538648634
24033807102,240338071021,512,232,174,918,2.990284311,0.081553208,1.262568273,0.422223488
24033807102,240338071022,787,386,159,1332,2.990284311,0.081553208,1.727716039,0.577776512
24033807301,240338073011,1177,318,107,1602,3.850017295,0.105000472,1.92609118,0.500281176
24033807301,240338073012,781,312,289,1382,3.850017295,0.105000472,1.923926116,0.499718824
24033807305,240338073051,866,420,205,1491,4.238475882,0.115594797,1.964754128,0.463552037
24033807305,240338073052,824,486,318,1628,4.238475882,0.115594797,2.273721754,0.536447963
24033807404,240338074041,659,442,219,1320,5.864734785,0.159947312,1.808569972,0.308380522
24033807404,240338074042,948,420,196,1564,5.864734785,0.159947312,2.030423444,0.346208911
24033807404,240338074043,749,494,241,1484,5.864734785,0.159947312,2.02574137,0.345410567
24033807405,240338074051,526,371,311,1208,7.068565771,0.192779066,1.786007808,0.252669051
24033807405,240338074052,928,653,380,1961,7.068565771,0.192779066,2.755433737,0.389815109
24033807405,240338074053,1258,546,195,1999,7.068565771,0.192779066,2.527124226,0.357515839
24033807407,240338074071,642,271,105,1018,7.363524233,0.200823388,1.292073841,0.17546949
24033807407,240338074072,532,393,292,1217,7.363524233,0.200823388,1.777960816,0.241455146
24033807407,240338074073,382,276,188,846,7.363524233,0.200823388,1.217690204,0.165367854
24033807407,240338074074,693,638,313,1644,7.363524233,0.200823388,2.33039317,0.316477966
24033807407,240338074075,284,221,62,567,7.363524233,0.200823388,0.745406203,0.101229544
24033807408,240338074081,796,518,345,1659,6.853472094,0.186912875,2.350639441,0.342985192
24033807408,240338074082,550,528,431,1509,6.853472094,0.186912875,2.304851077,0.336304146
24033807408,240338074083,729,607,258,1594,6.853472094,0.186912875,2.197981576,0.320710663
24033807409,240338073041,878,543,369,1790,6.430785245,0.175385052,2.527290188,0.392998692
24033807409,240338074091,265,151,222,638,6.430785245,0.175385052,1.003292883,0.156014055
24033807409,240338074092,238,172,98,508,6.430785245,0.175385052,0.714100425,0.111044048
24033807409,240338074093,1106,566,106,1778,6.430785245,0.175385052,2.186101749,0.339943205
24033807410,240338074101,912,557,1932,3401,8.197869102,0.223578248,6.227915308,0.759699287
24033807410,240338074102,758,446,241,1445,8.197869102,0.223578248,1.969953794,0.240300713
24033807500,240338075001,1071,588,369,2028,7.4565988,0.203361785,2.792479828,0.374497798
24033807500,240338075002,545,351,190,1086,7.4565988,0.203361785,1.496651348,0.200715016
24033807500,240338075003,1527,734,238,2499,7.4565988,0.203361785,3.167467624,0.424787186